filename, language, Java, Markdown, Database, comment, blank, total
A38.java, Java, 15, 0, 0, 0, 9, 24
A38Object.java, Java, 9, 0, 0, 0, 4, 13
AddButton.java, Java, 28, 0, 0, 0, 8, 36
Armoire.java, Java, 33, 0, 0, 0, 12, 45
Batiment.java, Java, 49, 0, 0, 0, 18, 67
Center.java, Java, 187, 0, 0, 0, 80, 267
CenterTable.java, Java, 53, 0, 0, 2, 14, 69
CenterTableControl.java, Java, 38, 0, 0, 0, 13, 51
DeleteButton.java, Java, 26, 0, 0, 0, 10, 36
EditButton.java, Java, 29, 0, 0, 0, 9, 38
Emprunt.java, Java, 66, 0, 0, 0, 20, 86
Individu.java, Java, 44, 0, 0, 0, 13, 57
Institution.java, Java, 19, 0, 0, 0, 5, 24
Interface.java, Java, 137, 0, 0, 0, 37, 174
Materiel.java, Java, 76, 0, 0, 0, 24, 100
MaterielComboControl.java, Java, 20, 0, 0, 0, 5, 25
Menu.java, Java, 49, 0, 0, 0, 16, 65
MenuButton.java, Java, 18, 0, 0, 0, 10, 28
MenuControl.java, Java, 21, 0, 0, 0, 11, 32
Modele.java, Java, 669, 0, 0, 11, 242, 922
Peripherique.java, Java, 2, 0, 0, 0, 1, 3
Personne.java, Java, 31, 0, 0, 0, 13, 44
README.md, Markdown, 0, 2, 0, 0, 1, 3
Salle.java, Java, 49, 0, 0, 0, 16, 65
Side.java, Java, 416, 0, 0, 0, 161, 577
SideButton.java, Java, 30, 0, 0, 0, 12, 42
SideCancelButton.java, Java, 27, 0, 0, 0, 12, 39
SideComboBox.java, Java, 11, 0, 0, 0, 5, 16
SideControl.java, Java, 77, 0, 0, 0, 32, 109
SideLabel.java, Java, 12, 0, 0, 0, 5, 17
SideSaveButton.java, Java, 51, 0, 0, 0, 17, 68
SideTextField.java, Java, 20, 0, 0, 0, 9, 29
Terminal.java, Java, 30, 0, 0, 0, 10, 40
Topbar.java, Java, 32, 0, 0, 0, 13, 45
TopbarControl.java, Java, 17, 0, 0, 0, 10, 27
a38.db, Database, 0, 0, 102, 0, 3, 105
Total, -, 2391, 2, 102, 13, 880, 3388